##################
#             # #
#          #  # #
#####   #  #  # #
#       #  #    #
#   ### #  #    #
#  ###          #
#      #        #
##############*##